9 20 10
####################
#*                 #
#################  #
#                  #
#  #################
#                  #
#################  #
#                  #
####################
