15 10 4
##########
#        #
# #### # #
# #    # #
# # ## # #
# # ## # #
# # ## # #
# # #### #
# #      #
# #*## ###
# # #    #
# #    # #
# ## ### #
#        #
##########
15 10 7
##########
#    *   #
# #### # #
# #    # #
# # ## # #
# # ## # #
# # ## # #
# # #### #
# #      #
# # ## ###
# # #    #
# #    # #
# ## ### #
#        #
##########
