10 20 10
####################
#                  #
# ################ #
# ################ #
# ################ #
# ################ #
# ################ #
# ################ #
#      *           #
####################
